69 4 5 5 6 7 20 21 21 21 22 39 40 41 42 43 0 0 59 4 5 5 6 5 5 6 7 44 45 45 45 46 20 21 21 21 22 0 0 59 4 5 5 5 7 0 0 59 4 5 5 69
69 9 9 9 9 8 23 24 25 26 27 44 45 45 45 46 0 0 60 9 9 9 9 9 9 9 8 47 48 48 48 49 23 24 25 26 27 0 0 60 9 9 9 9 8 0 0 60 9 9 9 69
69 10 18 18 10 17 28 29 29 29 30 47 48 48 48 49 0 0 19 10 18 18 10 18 18 10 17 47 48 48 48 49 28 29 29 29 30 0 0 19 10 18 18 10 17 0 0 19 10 18 18 69
69 10 18 18 10 17 31 32 32 32 33 47 50 48 50 49 0 0 19 10 18 18 10 18 18 10 17 47 50 48 50 49 31 32 32 32 33 0 0 19 10 18 18 10 17 0 0 19 10 18 18 69
69 10 18 18 10 17 31 34 32 34 33 47 51 48 51 49 0 0 19 10 18 18 10 18 18 10 17 47 51 48 51 49 31 34 32 34 33 0 0 19 10 18 18 10 17 0 0 19 10 18 18 69
69 10 18 18 10 17 31 32 32 32 33 47 48 48 48 49 0 0 19 10 18 18 10 18 18 10 17 47 48 48 48 49 31 32 32 32 33 56 56 19 10 18 18 10 17 0 0 19 10 18 18 69
69 10 13 14 10 17 35 36 38 36 37 47 48 48 48 49 56 56 19 10 13 14 10 13 14 10 17 52 53 54 53 55 35 36 38 36 37 57 57 19 10 13 14 10 17 56 56 19 10 13 14 69
69 11 12 15 11 16 0 0 0 0 0 52 53 54 53 55 57 57 58 11 12 15 11 12 15 11 16 0 0 0 0 0 0 0 0 0 0 0 0 58 11 12 15 11 16 57 57 58 11 12 15 69
69 0 1 1 1 1 1 1 1 1 1 1 1 1 1 1 1 1 1 1 1 1 1 1 1 1 1 1 1 1 1 1 1 1 1 1 1 1 1 1 1 1 1 1 1 1 1 1 1 1 0 69
69 0 3 3 3 3 3 3 3 3 3 3 3 3 3 3 3 3 3 3 3 3 67 3 3 3 67 3 3 3 3 3 3 3 3 3 3 3 3 3 3 3 3 3 3 3 3 3 3 3 0 69
69 0 3 3 3 3 3 3 3 3 3 3 3 3 3 3 3 3 3 3 3 3 67 3 3 3 67 3 3 3 3 3 3 3 3 3 3 3 3 3 3 3 3 3 3 3 3 3 3 3 0 69
69 0 3 3 3 3 3 3 3 3 3 3 3 3 3 3 3 3 3 3 3 3 67 3 3 3 67 3 3 3 3 3 3 3 3 3 3 3 3 3 3 3 3 3 3 3 3 3 3 3 0 69
69 0 3 3 3 0 0 0 0 0 0 0 0 0 0 0 0 0 0 0 0 0 0 0 0 0 0 0 0 0 0 0 0 0 0 0 0 0 0 0 0 0 0 0 0 0 0 3 3 3 0 69
69 0 3 3 3 0 2 2 2 2 2 2 2 2 2 2 2 2 2 2 2 2 2 0 0 2 2 2 2 2 2 2 2 2 2 2 64 2 2 2 2 2 2 2 2 2 0 3 3 3 0 69
69 0 3 3 3 0 2 2 62 2 2 2 2 2 2 2 2 2 2 2 2 2 2 0 0 2 2 2 2 2 2 2 2 2 2 2 63 2 2 2 2 2 62 2 2 2 0 3 3 3 0 69
69 0 3 3 3 0 2 2 61 2 2 2 2 2 2 2 2 2 2 2 2 2 2 0 0 2 2 2 2 62 2 2 2 2 2 2 2 2 2 2 2 2 61 2 2 2 0 3 3 3 0 69
69 0 3 3 3 0 2 2 2 2 2 2 2 2 2 2 64 2 2 2 2 2 2 0 0 2 2 2 2 61 2 2 2 2 2 2 2 2 2 2 2 2 2 2 2 2 0 3 3 3 0 69
69 0 3 3 3 0 2 2 2 2 2 2 2 2 2 2 63 2 2 2 2 2 2 0 0 2 2 2 2 2 2 2 2 2 2 2 2 2 2 2 2 2 2 64 2 2 0 3 3 3 0 69
69 0 3 3 3 0 2 2 2 2 2 2 2 2 2 2 2 2 2 2 2 2 2 0 0 2 2 2 2 2 2 2 2 2 2 2 2 66 2 2 2 2 2 63 2 2 0 3 3 3 0 69
69 0 3 3 3 0 2 2 2 2 2 62 2 2 2 2 2 2 2 2 66 2 2 0 0 2 2 2 2 2 2 2 2 2 2 2 2 65 2 2 2 2 2 2 2 2 0 3 3 3 0 69
69 0 3 3 3 0 2 2 2 2 2 61 2 2 2 2 2 2 2 2 65 2 2 0 0 2 2 2 64 2 2 2 2 2 2 2 2 2 2 2 2 2 2 2 2 2 0 3 3 3 0 69
69 0 3 3 3 0 2 66 2 2 2 2 2 2 2 2 2 2 2 2 2 2 2 0 0 2 2 2 63 2 2 2 2 2 2 2 2 64 2 2 2 2 2 2 2 2 0 3 3 3 0 69
69 0 3 3 3 0 2 65 2 2 2 2 2 2 2 2 2 2 2 2 2 2 2 0 0 2 2 2 2 2 2 2 2 2 2 2 2 63 2 2 2 2 66 2 2 2 0 3 3 3 0 69
69 0 3 3 3 0 2 2 2 2 2 2 2 2 66 2 2 0 0 0 0 0 0 0 0 0 0 0 0 0 0 2 2 62 2 2 2 2 2 2 2 2 65 2 2 2 0 3 3 3 0 69
69 0 3 3 3 0 2 2 2 2 2 2 2 2 65 2 2 0 0 1 1 1 1 1 1 1 1 1 1 0 0 2 2 61 2 2 2 2 2 2 2 2 2 2 2 2 0 3 3 3 0 69
69 0 3 3 3 0 2 2 2 2 2 2 2 2 2 2 2 0 0 2 2 2 2 2 2 62 2 2 2 0 0 2 2 2 2 2 2 2 2 2 2 2 2 2 2 2 0 3 3 3 0 69
69 0 3 3 3 0 2 2 2 2 2 2 2 2 2 2 2 0 0 2 2 2 2 2 2 61 2 2 2 0 0 2 2 2 2 2 2 2 64 2 2 2 2 2 2 2 0 3 3 3 0 69
69 0 3 3 3 0 2 2 2 2 64 2 2 2 2 2 2 0 0 2 2 64 2 2 2 2 2 2 2 0 0 2 2 2 2 2 2 2 63 2 2 2 2 2 2 2 0 3 3 3 0 69
69 0 68 68 68 0 2 2 2 2 63 2 2 2 2 2 2 0 0 2 2 63 2 2 2 2 2 2 2 0 0 2 2 2 2 2 2 2 2 2 2 2 2 2 2 2 0 68 68 68 0 69
69 0 3 3 3 0 0 0 0 0 0 0 0 0 0 0 0 0 0 2 2 2 2 2 2 2 2 2 2 0 0 0 0 0 0 0 0 0 0 0 0 0 0 0 0 0 0 3 3 3 0 69
69 0 3 3 3 0 1 1 1 1 1 1 1 1 1 1 1 0 0 2 2 2 2 2 2 2 2 64 2 0 0 1 1 1 1 1 1 1 1 1 1 1 1 1 1 1 0 3 3 3 0 69
69 0 68 68 68 0 2 2 2 2 2 2 2 2 2 2 2 0 0 2 2 2 2 2 2 2 2 63 2 0 0 2 2 2 2 2 2 2 2 2 2 2 2 2 2 2 0 68 68 68 0 69
69 0 3 3 3 0 2 2 2 2 2 2 62 2 2 2 2 0 0 2 2 2 64 2 2 2 2 2 2 0 0 2 2 2 66 2 2 2 2 2 2 2 2 2 2 2 0 3 3 3 0 69
69 0 3 3 3 0 2 2 2 2 2 2 61 2 2 2 2 0 0 2 2 2 63 2 2 2 2 2 2 0 0 2 2 2 65 2 2 2 2 2 2 2 2 64 2 2 0 3 3 3 0 69
69 0 3 3 3 0 2 2 62 2 2 2 2 2 2 2 2 0 0 2 2 2 2 2 2 2 2 2 2 0 0 2 2 2 2 2 2 2 2 2 2 2 2 63 2 2 0 3 3 3 0 69
69 0 3 3 3 0 2 2 61 2 2 2 2 2 2 2 2 0 0 0 0 0 0 0 0 0 0 0 0 0 0 2 2 2 2 2 2 2 2 2 2 2 2 2 2 2 0 3 3 3 0 69
69 0 3 3 3 0 2 2 2 2 2 2 2 2 2 2 2 1 1 1 1 1 1 0 0 1 1 1 1 1 1 2 2 2 64 2 2 2 2 2 2 2 2 2 2 2 0 3 3 3 0 69
69 0 3 3 3 0 2 2 2 2 2 2 2 2 2 2 2 2 2 2 2 2 2 0 0 2 2 2 2 2 2 2 2 2 63 2 2 2 2 2 2 2 2 2 2 2 0 3 3 3 0 69
69 0 3 3 3 0 2 2 2 2 2 62 2 2 2 2 2 2 2 2 2 2 2 0 0 2 2 2 2 2 2 2 2 2 2 2 2 2 2 2 2 2 64 2 2 2 0 3 3 3 0 69
69 0 3 3 3 0 2 2 2 2 2 61 2 2 2 2 2 2 2 64 2 2 2 0 0 2 2 2 2 64 2 2 2 2 2 2 2 2 2 2 2 2 63 2 2 2 0 3 3 3 0 69
69 0 3 3 3 0 2 66 2 2 2 2 2 2 2 2 2 2 2 63 2 2 2 0 0 2 2 2 2 63 2 2 2 2 2 2 2 2 2 2 2 2 2 2 2 2 0 3 3 3 0 69
69 0 3 3 3 0 2 65 2 2 2 2 2 2 2 2 2 2 2 2 2 2 2 0 0 2 2 2 2 2 2 2 2 2 2 2 2 2 2 2 2 2 2 2 2 2 0 3 3 3 0 69
69 0 3 3 3 0 2 2 2 2 2 2 2 62 2 2 2 2 2 2 2 2 2 0 0 2 2 2 2 2 2 2 2 2 2 2 2 2 2 2 64 2 2 2 2 2 0 3 3 3 0 69
69 0 3 3 3 0 2 2 2 2 2 2 2 61 2 2 2 2 2 2 2 2 2 0 0 2 2 2 2 2 2 2 2 2 2 2 2 2 2 2 63 2 2 2 2 2 0 3 3 3 0 69
69 0 3 3 3 0 2 2 2 2 2 2 2 2 2 2 2 2 2 2 2 2 2 0 0 2 2 2 2 2 2 2 2 2 2 2 2 2 2 2 2 2 2 2 2 2 0 3 3 3 0 69
69 0 3 3 3 0 2 2 2 2 2 2 2 2 2 2 2 2 2 2 2 2 2 0 0 2 2 2 2 2 2 2 2 2 64 2 2 2 2 2 2 2 2 2 2 2 0 3 3 3 0 69
69 0 3 3 3 0 2 2 2 64 2 2 2 2 2 2 2 62 2 2 2 2 2 0 0 2 2 2 64 2 2 2 2 2 63 2 2 2 2 2 2 2 2 2 2 2 0 3 3 3 0 69
69 0 3 3 3 0 2 2 2 63 2 2 2 2 2 2 2 61 2 2 2 2 2 0 0 2 2 2 63 2 2 2 2 2 2 2 2 2 2 2 2 2 2 2 2 2 0 3 3 3 0 69
69 0 3 3 3 0 2 2 2 2 2 2 2 2 2 2 2 2 2 2 2 2 2 0 0 2 2 2 2 2 2 2 2 2 2 2 2 2 2 2 2 2 2 66 2 2 0 3 3 3 0 69
69 0 3 3 3 0 2 2 2 2 2 2 2 2 2 2 2 2 2 2 2 2 2 0 0 2 2 2 2 2 2 2 2 2 2 2 2 2 2 2 2 2 2 65 2 2 0 3 3 3 0 69
69 69 69 69 69 69 69 69 69 69 69 69 69 69 69 69 69 69 69 69 69 69 69 69 69 69 69 69 69 69 69 69 69 69 69 69 69 69 69 69 69 69 69 69 69 69 69 69 69 69 69 69 69 69 69